1: BOT, DUS
2: BAD, MAN, NKRH, NKRL, LBU
3: GED, GIN, HEF, SIG, TAU
4: DKB, HAB, KNG, KTG, PSA
5: EIF, KIR, PFA, RUD
6: HMM, PADH, PADL
7: DKA, NOR
8: REU, STG
10: ADF


TAU: OBOKA-Dep, ROLIS-Inbounds -> EDDF, ETAR, ETAD, EDFH, EDDK-Inbounds über GULKO
SIG: DUS-TMA-Dep: DODEN, KUMIK; EDDK-Dep: KUMIK; EDLW, EDDG-Dep: GMH, EDGS
GIN: EDDF MARUN/TOBAK-Dep, EDLP-Dep
HEF: EDDF-Tobak-Dep vom GIN, EDDF-Inb von EDWW über NATSU-KERAX
	UPPER>LOWER-Trans > EDLP, EDLW, EDDK: DEMPA, GEFDA, VELES
				EDDV Inbounds
GED: EDDF-Inb von EDYY, EDWW, EDMM: RIMET, TAMEB, VAGAP -> KERAX
HMM: EDDL-Inb/Out MEVEL/HALME, maybe EHAM-Outbounds, EHAH-In/Out, EDDG, EDDK-Inb SONEB-GMH, OSN->EDLW/EDLP an PADL, LW/LP Outbounds
PADH: DOMUX-DUS-Inbounds, EDDK-Dep/Out KOPAG/PODEP, EDLW/EDDG-Dep-GMH, EDDF-Out MARUN/ARPEG/EXACK, DUS-DEP NUDGO
PADL: EDLW/EDLP-In/Out / EDDK-In BATEP/ERNEP
BOT: EDDL-Arr TEBRO-PISAP, EDLV-Dep/Out, ETNG-Dep/Out EDDL-Dep MODRU, NETEX, MEVEL, SONEB, EHEH-Dep/Arr VELNI
DUS: EDDL-Terminal + EDLN
DKA: EDDK-Dep/Arr, ETNN-Dep/Arr
NOR: EDDF-Oboka, EDDL-Bikmu, EBBR-UMUPU-ASDAK + AGENI, EBBR/ELLX-Outbounds, Transition ELDAR, EDLW/EDDK-Dep NAVAK
EIF: ETSB-Dep/Arr, EDFH-Dep/Arr, ETAD-Dep/Arr, ETOU-Dep/Arr, 
RUD: EDDF-UNOKO Arrivals
PFA: EDDR-Dep/Arr, ETAR-Dep/Arr
KIR: EDDF-Outbounds SOBRA/ULGIK, EDFH->Eifel, EBBR/ELLX/EBLG-Dep/Out
DKB: EDDF-Outbounds CINDY->NOMBO, EDDN/EDDS-Dep/Arr
KNG: EDDF-Outbounds Cindy, Sulus(25), EMPAX-Arrival von BAD
PSA: Holdings SPESA
HAB: EDDF-Dep Sulus(07), Trans-Upper-Lower EDDN/EDDS
KTG: EDDF-Dep Sulus(18/25), EDDF-Arr FAWUR/ASPAT, EDDS-Dep NE, EDDM-Dep scheiß climb
BAD: LSZH-Dep/Arr, Aneki-Dep, EDDS-Dep, LFST-Arr, EMPAX Upper-Lower-Trans
NKRL: EDFM-Dep/Arr
NKRH: EDDF-Dep ANEKI, EDDK-Inbounds Upper-Lower-Trans, EDDS-Dep Nord
MAN: Crossing-Traffic, EDFH-Inbounds
LBU: EMPAX-Inbounds nach EDDF
